.#E.####.#
.#..#...#.
.##.#.##.#
......##..
#####.....
.#..#..###
......#...
...####.S.
##...#..#.
..#......#
